11111111111111111111
10000000000000000001
10000000000000000001
10000000000000000001
10000000000000000001
10000000000000000001
10000000000000000001
10000011000000000001
10000011000000000001
10000000000000000001
10000000000000000001
10000000000000001001
10000000001111101111
10000000001000000001
10001000001011111001
10000010001000000001
10001000001111011101
10000000001111000001
10000000000000001111
11111111111111111111
